{
    "name": "FlyAway",
    "beatsPerMinute": 296,
    "beatsPerRow": 1,
    "duration": {
        "minutes": 3,
        "seconds": 14
    },
    "map": [
        [0,0,0,1,0],
        [0,0,0,1,0],
        [0,0,0,1,0],
        [0,0,0,1,0],
        [0,0,0,1,0],
        [0,0,1,0,0],
        [0,0,1,0,0],    
        [0,0,1,0,0],
        [0,0,1,0,0],
        [0,0,1,0,0],
        [0,0,1,0,0],
        [0,0,1,0,0],
        [0,1,0,0,0],
        [0,1,0,0,0],
        [0,1,0,0,0],
        [0,0,1,0,0],
        [0,0,1,0,0],
        [0,0,1,0,0],
        [0,0,1,0,0],
        [0,0,1,0,0],
        [0,0,1,0,0],
        [0,0,1,0,0],
        [0,0,0,1,0],
        [0,0,0,1,0],
        [0,0,1,0,0],
        [0,1,0,0,0],
        [1,0,0,0,0],
        [1,0,0,0,0],
        [1,0,0,0,0],
        [1,0,0,0,0],
        [0,1,0,0,0],
        [0,0,1,0,0],
        [0,0,0,1,0],
        [1,0,0,0,1],
        [0,0,0,0,1],
        [0,0,0,1,0],
        [0,0,1,0,0],
        [0,0,1,0,0],
        [0,1,0,0,0],
        [1,0,0,0,0],
        [0,1,0,0,0],
        [0,0,0,1,0],
        [0,0,1,0,0],
        [1,0,0,0,0],
        [1,0,0,0,0],
        [1,0,0,0,0],
        [0,1,0,0,0],
        [0,0,0,1,0],
        [0,0,1,0,0],
        [0,0,0,0,1],
        [0,0,0,0,1],
        [0,0,0,0,1],
        [0,0,0,0,1],
        [0,0,0,1,0],
        [0,0,1,0,0],
        [1,0,0,0,0],
        [0,1,0,0,0],
        [1,0,0,0,0],
        [0,1,0,0,0],
        [0,0,0,1,0],
        [0,0,1,0,0],
        [0,0,1,0,0],
        [0,1,0,0,0],
        [1,0,0,0,0],
        [1,0,0,0,0],
        [0,1,0,0,0],
        [0,0,1,0,0],
        [0,0,0,1,0],
        [0,0,0,1,0],
        [1,0,0,0,1],
        [0,0,0,0,1],
        [0,0,0,0,1],
        [0,0,1,0,0],
        [0,0,1,0,0],
        [0,0,0,1,0],
        [0,1,0,0,0],
        [0,0,1,0,0],
        [0,0,0,1,0],
        [0,0,1,0,0],
        [0,1,0,0,0],
        [1,0,0,0,0],
        [1,0,0,0,0],
        [0,0,1,0,0],
        [0,0,0,0,1],
        [0,0,1,0,0],
        [0,0,1,0,0],
        [0,1,0,0,0],
        [1,0,0,0,0],
        [0,1,0,0,0],
        [0,0,0,1,0],
        [0,0,1,0,0],
        [0,0,0,1,0],
        [0,0,0,0,1],
        [0,0,0,0,1],
        [0,0,0,0,1],
        [0,0,0,1,0],
        [0,0,1,0,0],
        [1,0,0,0,0],
        [0,1,0,0,0],
        [1,0,0,0,0],
        [0,0,1,0,0],
        [0,0,0,1,0],
        [0,0,1,0,0],
        [0,0,0,1,0],
        [0,0,0,0,1],
        [1,0,0,1,0],
        [0,0,0,0,1],
        [0,0,0,1,0],
        [0,0,1,0,0],
        [0,0,1,0,0],
        [0,0,1,0,0],
        [1,0,0,0,0],
        [0,1,0,0,0],
        [0,0,0,1,0],
        [0,0,1,0,0],
        [0,1,0,0,0],
        [0,0,1,0,0],
        [0,0,0,1,0],
        [0,0,0,0,1],
        [0,0,0,1,0],
        [0,0,1,0,0],
        [0,0,0,1,0],
        [0,0,0,1,0],
        [0,1,0,0,0],
        [0,1,0,0,0],
        [0,0,0,1,0],
        [0,0,0,0,1],
        [0,0,0,1,0],
        [0,0,0,0,1],
        [0,0,0,0,1],
        [0,0,0,0,1],
        [0,0,0,1,0],
        [0,0,1,0,0],
        [0,0,0,1,0],
        [0,1,0,0,0],
        [1,0,0,0,0],
        [1,0,0,0,0],
        [0,0,1,0,0],
        [0,0,1,0,0],
        [0,0,0,0,1],
        [0,0,0,0,1],
        [0,0,1,0,0],
        [0,0,0,0,1],
        [0,0,0,1,0],
        [0,0,1,0,0],
        [0,0,0,1,0],
        [0,0,1,0,0],
        [0,1,0,0,0],
        [1,0,0,0,0],
        [0,0,0,1,0],
        [0,0,1,0,0],
        [0,0,0,1,0],
        [0,0,0,1,0],
        [0,0,0,1,0],
        [0,0,0,0,1],
        [0,0,0,1,0],
        [0,0,1,0,0],
        [0,0,0,1,0],
        [0,0,0,1,0],
        [0,0,0,1,0],
        [0,0,0,0,1],
        [0,0,0,1,0],
        [0,1,0,0,0],
        [0,1,0,0,0],
        [1,0,0,0,0],
        [1,0,0,0,0],
        [0,1,0,0,0],
        [0,0,0,1,0],
        [0,1,0,0,0],
        [0,0,1,0,0],
        [0,1,0,0,0],
        [1,0,0,0,0],
        [0,1,0,0,0],
        [0,0,0,1,0],
        [0,0,0,0,1],
        [0,0,0,1,0],
        [0,0,0,0,1],
        [0,0,0,1,0],
        [0,0,0,0,1],
        [0,0,0,1,0],
        [0,0,0,0,1],
        [0,0,1,0,0],
        [0,0,1,0,0],
        [1,0,0,0,0],
        [0,1,0,0,0],
        [0,0,0,1,0],
        [0,0,0,1,0],
        [0,0,1,0,0],
        [0,0,1,0,0],
        [1,0,0,0,0],
        [1,0,0,0,0],
        [0,0,1,0,0],
        [0,0,1,0,0],
        [0,0,0,0,1],
        [0,0,0,0,1],
        [0,0,0,1,0],
        [0,0,0,1,0],
        [0,1,0,0,0],
        [0,1,0,0,0],
        [0,0,0,1,0],
        [0,0,1,0,0],
        [1,0,0,0,0],
        [0,0,1,0,0],
        [0,0,0,1,0],
        [0,0,1,0,0],
        [0,0,0,0,1],
        [0,0,0,1,0],
        [0,0,1,0,0],
        [0,1,0,0,0],
        [1,0,0,0,0],
        [0,1,0,0,0],
        [0,0,1,0,0],
        [0,0,0,1,0],
        [0,0,0,0,1],
        [0,0,0,0,1],
        [0,0,1,0,0],
        [0,0,0,1,0],
        [0,0,0,1,0],
        [0,0,0,1,0],
        [0,1,0,0,0],
        [1,0,0,0,0],
        [1,0,0,0,0],
        [0,0,1,0,0],
        [0,0,0,1,0],
        [0,0,1,0,0],
        [0,0,0,1,0],
        [0,0,0,0,1],
        [0,0,0,1,0],
        [0,0,0,0,1],
        [0,0,0,0,1],
        [0,0,0,1,0],
        [0,1,0,0,0],
        [0,0,1,0,0],
        [0,1,0,0,0],
        [0,0,1,0,0],
        [0,1,0,0,0],
        [0,0,1,0,0],
        [1,0,0,0,0],
        [0,1,0,0,0],
        [0,0,0,1,0],
        [0,0,1,0,0],
        [0,0,0,0,0],
        [0,1,0,0,0],
        [1,0,0,0,0],
        [0,0,1,0,0],
        [0,0,0,1,0],
        [0,0,1,0,0],
        [0,0,1,0,0],
        [0,0,1,0,0],
        [0,0,1,0,0],
        [0,0,1,0,0],
        [0,0,0,1,0],
        [0,0,1,0,0],
        [0,0,1,0,0],
        [0,1,0,0,0],
        [0,0,1,0,0],
        [0,0,1,0,0],
        [0,0,0,1,0],
        [0,0,1,0,0],
        [0,0,0,1,0],
        [0,0,0,1,0],
        [0,0,0,0,1],
        [0,0,0,0,1],
        [0,0,0,1,0],
        [0,1,0,0,0],
        [0,1,0,0,0],
        [1,0,0,0,0],
        [1,0,0,0,0],
        [0,1,0,0,0],
        [0,1,0,0,0],
        [0,0,1,0,0],
        [0,1,0,0,0],
        [1,0,0,0,0],
        [1,0,0,0,0],
        [0,0,1,0,0],
        [0,0,0,1,0],
        [0,0,0,0,1],
        [0,0,0,1,0],
        [0,0,0,0,1],
        [0,0,1,0,0],
        [0,1,0,0,0],
        [0,0,0,1,0],
        [0,1,0,0,0],
        [0,1,0,0,0],
        [0,0,1,0,0],
        [1,0,0,0,0],
        [0,1,0,0,0],
        [0,0,0,1,0],
        [0,1,0,0,0],
        [0,1,0,0,0],
        [0,0,1,0,0],
        [1,0,0,0,0],
        [1,0,0,0,0],
        [1,0,0,0,0],
        [0,0,1,0,0],
        [0,0,1,0,0],
        [0,0,1,0,0],
        [0,1,0,0,0],
        [0,1,0,0,0],
        [0,0,0,1,0],
        [0,0,1,0,0],
        [0,1,0,0,0],
        [0,0,1,0,0],
        [1,0,0,0,0],
        [0,0,1,0,0],
        [0,0,0,1,0],
        [1,0,0,0,0],
        [0,1,0,0,0],
        [0,0,1,0,0],
        [1,0,0,0,0],
        [1,0,0,0,0],
        [0,0,0,1,0],
        [0,0,0,0,1],
        [0,0,0,1,0],
        [0,0,0,1,0],
        [0,1,0,0,0],
        [0,0,0,1,0],
        [0,0,0,1,0],
        [0,0,1,0,0],
        [0,0,0,0,1],
        [0,0,0,1,0],
        [0,0,0,0,1],
        [0,0,0,0,1],
        [0,0,1,0,0],
        [0,0,0,1,0],
        [0,0,1,0,0],
        [0,0,0,1,0],
        [0,0,0,1,0],
        [0,0,0,0,1],
        [0,0,0,1,0],
        [0,0,0,0,1],
        [0,0,1,0,0],
        [0,1,0,0,0],
        [1,0,0,0,0],
        [0,1,0,0,0],
        [0,0,1,0,0],
        [0,0,1,0,0],
        [0,1,0,0,0],
        [0,0,1,0,0],
        [0,0,0,1,0],
        [0,0,0,0,1],
        [0,0,0,0,1],
        [0,0,0,0,1],
        [0,0,1,0,0],
        [0,0,1,0,0],
        [1,0,0,0,0],
        [0,1,0,0,0],
        [0,0,0,1,0],
        [0,0,1,0,0],
        [0,1,0,0,0],
        [0,0,1,0,0],
        [0,1,0,0,0],
        [0,0,0,1,0],
        [0,0,0,1,0],
        [0,0,1,0,0],
        [0,0,0,1,0],
        [0,0,1,0,0],
        [1,0,0,0,0],
        [0,0,1,0,0],
        [0,0,0,1,0],
        [0,0,0,1,0],
        [0,0,1,0,0],
        [0,0,1,0,0],
        [0,1,0,0,0],
        [0,0,1,0,0],
        [0,0,0,0,1],
        [0,0,0,0,1],
        [0,0,0,1,0],
        [0,0,0,1,0],
        [0,1,0,0,0],
        [0,1,0,0,0],
        [0,1,0,0,0],
        [0,0,1,0,0],
        [0,1,0,0,0],
        [0,0,1,0,0],
        [0,0,1,0,0],
        [0,0,0,0,1],
        [0,0,0,1,0],
        [0,0,1,0,0],
        [0,1,0,0,0],
        [0,1,0,0,0],
        [1,0,0,0,0]
    ]
}
