{
    "name": "FlyAway",
    "beatsPerMinute": 148,
    "beatsPerRow": 1,
    "duration": {
        "minutes": 3,
        "seconds": 14
    },
    "map": [
        [0,0,0,0,0],
        [0,0,0,0,0],
        [0,0,0,0,0],
        [0,0,0,0,0],
        [0,0,0,0,0],
        [0,0,0,0,0],
        [0,0,0,0,0],    
        [0,0,0,0,0],
        [0,0,0,0,0],
        [0,0,0,0,0],
        [0,0,0,0,0],
        [0,0,0,0,0],
        [0,0,0,0,0],
        [0,0,0,0,0],
        [0,0,0,0,0],
        [0,0,0,0,0],
        [0,0,0,0,0],
        [0,0,0,0,0],
        [0,0,0,0,0],
        [0,0,0,0,0],
        [0,0,0,0,0],
        [0,0,0,0,0],
        [0,0,0,0,1],
        [0,0,0,1,0],
        [0,0,1,0,0],
        [0,0,0,0,0],
        [0,0,0,0,0],
        [1,0,0,0,0]
    ]
}